1,3,2,0,13,3
      #######  
####  ###  ##
#########  ####
####       ####
####        ###