#####
# -=#
#[]\#
#####
-
#####
#-=[#
#]\ #
#####