#####
# -=#
#123#
#;45#
#####
-
#####
#-=[#
#123#
#45 #
#####