#########
#       #
#       #
#11     #
#       #
#   B   #
#   B   #
#       #
#       #
#########
-
#########
#       #
#       #
#       #
#       #
#       #
#       #
#       #
#     11#
#########