######
#1223#
#1223#
#4556#
#4786#
#9  0#
######
-
######
#    #
#    #
#    #
# 22 #
# 22 #
######