#########
#AAA    #
#       #
#       #
#   #   #
#   # B #
#     B #
#     B #
#       #
#########
