1,3
    ####
    #  #
##### .#
#   #* #
#      #
#     +#
##  #  #
 #######