3,3
#######
#.   .#
#.***.#
##* *##
#.***.#
#.   .#
#######