1,1
########
#..   ##
# # ** #
#      #
########