1,2
   #####
####   #
# *  # #
#. *  .#
########