2,1
 #######
##.    #
#  **  #
#.  #  #
########