1,1
########
#  #   #
#  #.  #
#  # * #
## * ###
 #   #
 #.  #
 #####