11,8
    #####            
    #   #
    #*  #
  ###  *##
  #  * * #
### # ## #   #######
#   # ## #####   ..#
# *  *           ..#
##### ### # ##   ..#
    #     ##########
    #######