4,4
#########
#.     .#
# # + # #
#   *   #
#  * *  #
#   *   #
# # + # #
#.     .#
#########