4,4
#########
#.......#
#.* * * #
#* * * *#
# *   * #
#* * * *#
#   * *.#
# ......#
#########