7,4
############  
#..  #     ###
#..  # *  *  #
#..  #*####  #
#..      ##  #
#..  # #  * ##
###### ##* * #
  # *  * * * #
  #    #     #
  ############
 