2,3
#####
#  .#
# * #
## ##
##*##
#   #
#.  #
#####