4,4
#########
#.......#
#.* * * #
#* * * *#
# *   * #
#* * * *#
# * * *.#
#.......#
#########