7,4
############  
#..  #     ###
#..  # *  *  #
#..  #*####  #
#..      ##  #
#..    #  * ##
#####  ##* * #
  # *  * * * #
  #    #     #
  ############
 